1111111111111111
1E00000000001001
1010010000010101
1010011000000101
1P000000010000C1
1111111111111111