1111111111111
10010000000C1
1000011111001
100100C000001
1P00110000001
10E1000000111
1111111111111