111111111111111111111111
1E0000100000C00000000001
1110C1010100100100C10101
101000010101010001000011
1P0001000000000000000001
100100001000001C10000001
100001000010C00001100001
1C0100010000010000000001
1000001000C0000010001001
111111111111111111111111